5,7,4,4,0,0
+1,/8,NA,NA,NA,+1,/7
-7,-8,NA,+8,*2,/2,-1
+1,*3,+2,/5,NA,NA,+2
/6,*1,-3,NA,*1,*2,+5
*5,-2,+7,-1,+3,/2,-1